OOOOOOOO
OOOOOOOO
OO┌--┐OO
OO|OO|OO
OO|OO|OO
OO└--┘OO
OOOOOOOO
OOOOOOOO