OOOOOOOO
O┌-┬-┐OO
O├-+-┤OO
O|O|O|OO
O|O|O|OO
O└-┴-┘OO
OOOOOOOO
OOOOOOOO