OOOOSOOOO
OOOO|OOOO
OOOO└-┐OO
OO┌---┘OO
OO└---┐OO
OOOO┌-┘OO
OOOO|OOOO
OOOO|OOOO
OOOOBOOOO